XXXXXXXXXX
X.......BX
X.U....BFX
X.....BFCX
X.@.R..BFX
X.......BX
XXXXXXXXXX