..XXXXX.
XXX...X.
XC@R..X.
XXX.RCX.
XCXXR.X.
X.XCC.XX
XR.RRRCX
X...C..X
XXXXXXXX