XXXXXXXXXX
X...XX...X
X.K.XX.C.X
X...DD.B.X
X.@.XX.R.X
X...XX...X
XXXXXXXXXX